########################################################################################################################################################################################################
#                                                                                                                                                                                                      #
#                       @                                                                                                                                                                              #
#       #####                                        #####                                                                                                                                             #
#            #####                              #####                                                                                                                                                  #
#                 #####                    #####                                                                                                                                                       #
#                      ####################                                                                                                                                                            #
#                                                                                                                                                                                                      #
#                                                                                                                                                                                                      #
#                                                                                                                                                                                                      #
#     ##########          ##########         ##########                                                                                                                                                #
#                         ##########                                                                                                                                                                   #
#                         ##########                                                                                                                                                                   #
#         &               ##########                                                                                                                                                                   #
#                         ##########                                                                                                                                                                   #
#     ##########          ##########         ##########                                                                                                                                                #
#                                                                                                                                                                                                      #
#                                                                                                                                                                                                      #
#                                                                                                                                                                                                      #
#                                                                                                                                                                                                      #
#                                                                                                                                                                                                      #
#                     ####################                                                                                                                                                             #
#                #####                    #####                                                                                                                                                        #
#           #####                              #####                                                                                                                                                   #
#      #####                                        #####                                                                                                                                              #
#                                                                                                                                                                                                      #
#                                                                                                                                                                                                      #
#                              &                                                                                                                                                                       #
#                                                                                                                                                                                                      #
#       #####                                        #####                                                                                                                                             #
#            #####                              #####                                                                                                                                                  #
#                 #####                    #####                                                                                                                                                       #
#                      ####################                                                                                                                                                            #
#                                                                                                                                                                                                      #
#                                                  &                                                                                                                                                   #
#                                                                                                                                                                                                      #
#     ##########          ##########         ##########                                                                                                                                                #
#                         ##########                                                                                                                                                                   #
#                         ##########                                                                                                                                                                   #
#                         ##########                                                                                                                                                                   #
#                         ##########                                                                                                                                                                   #
#     ##########          ##########         ##########                                                                                                                                                #
#                                                                                                                                                                                                      #
#                                                                                                                                                                                                      #
#                                                                                                                                                                                                      #
#                                                                                                                                                                                                      #
#                                                                                                                                                                                                      #
#                     ####################                                                                                                                                                             #
#                #####                    #####                                                                                                                                                        #
#           #####                              #####                                                                                                                                                   #
#      #####                                        #####                                                                                                                                              #
#                                                                                                                                                                                                      #
#              &                                                                                                                                                                                       #
#                                                                                                                                                                                                      #
#                                                                                                                                                                                                      #
#       #####                                        #####                                                                                                                                             #
#            #####                              #####                                                                                                                                                  #
#                 #####                    #####                                                                                                                                                       #
#                      ####################                                                                                                                                                            #
#                                                                                                                                                                                                      #
#                                                                                                                                                                                                      #
#                                                                                                                                                                                                      #
#     ##########          ##########         ##########                                                                                                                                                #
#                         ##########                                                                                                                                                                   #
#                         ##########                                                                                                                                                                   #
#                         ##########              &                                                                                                                                                    #
#                         ##########                                                                                                                                                                   #
#     ##########          ##########         ##########                                                                                                                                                #
#                                                                                                                                                                                                      #
#                                                                                                                                                                                                      #
#                                                                                                                                                                                                      #
#                                                                                                                                                                                                      #
#                                                                                                                                                                                                      #
#                     ####################                                                                                                                                                             #
#                #####                    #####                                                                                                                                                        #
#           #####                              #####                                                                                                                                                   #
#      #####                 &                      #####                                                                                                                                              #
#                                                                                                                                                                                                      #
#                                                                                                                                                                                                      #
########################################################################################################################################################################################################
